// Comments
// GRASS = 0
// COIN = 1
// TREE = 2
// OBSTICAL = 3

0000000000
1100110022
2200110033
0033220011
0000011133
1112233300
1023102310
0123012031
0123012301
0000000000
1100110022
2200110033
0033220011
0000011133
1112233300
1023102310
0123012031
0123012301
0000000000
1100110022
2200110033
0033220011
0000011133
1112233300
1023102310
0123012031
0123012301