// Comments
// GRASS = 0
// COIN = 1
// TREE = 2
// OBSTICAL = 3
// FIRE = 4

001100031100000
101111411111411
001102013100000
101100011411411
001102011100000
102111113113131
001120031100000
101111411111411
001102013100200
101120011411411
201100011100200
102111113113131
001102031100000
101111411111411
000000200000000
000200002000000
001102013100000
101100011411411
001102011100200
102111113113131