// Comments
// GRASS = 0
// COIN = 1
// TREE = 2
// OBSTICAL = 3

0000000040
1100110022
2200110000
0030110011
0000011100
1110201040
1023101010
0123012031
0123012001
0000400400
1100110033
2200110000
0033220011
0400001100
0002233300
1023002310
0123010031
0123010301
0010100100
1100110022
2200110033
0011000011
0400011100
1112400000
1024102310
0123001001
0123010001