// Comments
// GRASS = 0
// COIN = 1
// TREE = 2
// OBSTICAL = 3

0000000000
1100110022
2200110000
0030110011
0000011100
1110201000
1023101010
0123012031
0123012001
0000000000
1100110033
2200110000
0033220011
0000001100
0002233300
1023002310
0123010031
0123010301
0010100100
1100110022
2200110033
0011000011
0000011100
1112200000
1023102310
0123001001
0123010001