// Comments
// GRASS = 0
// COIN = 1
// TREE = 2
// OBSTICAL = 3

0400000000
1100110022
2200110033
0033220011
0040011133
1112233300
1023102310
0123012031
0123012301
0000000400
1100110022
2200110033
0043220011
0400011133
1112234300
1023102310
0123012031
0143012301
0400400000
1100110022
2200110033
0033220011
0000011133
1112234300
1024102310
0123012031
0123014301