// Comments
// GRASS = 0
// COIN = 1
// TREE = 2
// OBSTICAL = 3
// FIRE = 4

001100031100000
101111411111411
001100013100000
101103011411411
001100011100000
102111113113131
001100031100000
101111411111411
001100013100000
101100011411411
001103011100000
102111113113131
001100031100000
101111411111411
300000000040000
000003000000000
001100013100040
101100011411411
001100011100000
102111113113131